1111111
1P00001
1110111
1E000E1
1111111