1111111
1P00001
1110111
1000001
1111111